{"layout":[
  ["", "<None>"],
  ["Q", "Q"],
  ["W", "W"],
  ["E", "E"],
  ["R", "R"],
  ["A", "A"],
  ["S", "S"],
  ["D", "D"],
  ["F", "F"],
  ["ERR", "<Error>"]
]}